start

# wall solid
. grass solid
, grassfull solid
_ blank solid
1 birb solid
2 kit solid
^ tree foreground
* cloud

                    
_  *               >
_         *        >
_                  >
_           *      >
_                  >
_     *            >
_                  >
_                  >
_                  >
_   ^  21 ^   ^^  ^>
....................
,,,,,,,,,,,,,,,,,,,,
,,,,,,,,,,,,,,,,,,,,
,,,,,,,,,,,,,,,,,,,,
,,,,,,,,,,,,,,,,,,,,
,,,,,,,,,,,,,,,,,,,,
,,,,,,,,,,,,,,,,,,,,